11111111111
1000C000001
100C00P00E1
11111111111