11111111111
10E00000011
10000C000P1
11111111111