11111111111
10000000001
1X000000001
11111111111