11111111111
110E000C001
10000C000P1
11111111111
