11111111111
10000000001
12000000001
11111111111