11111
1P0E1
100C1
10001
11111

1111
1P01
1EC1
1111
