11111111
1P0E1001
100C1001
100010C1
10C01001
10C00001
11111111