11111111
10E11001
10C00011
10P000C1
10000001
11111111